R 750 400
F 150,150,150
C 50,50,50

NO ./tex/redbrick.XPM
SO ./tex/greystone.XPM
WE ./tex/redbrick.XPM
EA ./tex/greystone.XPM
S ./tex/barrel.XPM



11111111111
10000000001
10000000001
10000S00001
10000000001
10000000001
10200000001
10000000001
10000200001
10000000001
10000000001
11111111111


