R 500 250
NO ./tex/redbrick.XPM
SO ./tex/greystone.XPM
WE ./tex/redbrick.XPM
EA ./tex/greystone.XPM
S ./tex/barrel.XPM
F 22,155,26
C 12,204,234



111   11111111111     11111111111
101   10100000001     10100000001
101   111111011111111110111111111
101   100000000000100000010000001111
101   1110000220001000000100000000011
111   1010000220001110000000002000021
      1110000000000000000000000011111
      122000000111111111110000001
      122000000000000000010000001
      111000010011111110010001111
      100000000000000000000001
111   101000010010000010010001
101   111111010010111010010001
111   100020010010001010010111111
      111000010010N01010010000001
111   101000010010001010010002001111
101   111000010011111010010000001
111   100000012000000000210000001
      120000010011111211111111111
111   100000210000000000000000001
101   111001110111011101110111021
111   101001010101210101012121001
      111111111111111111111111111



